3 10 47
Mission: Impossible - The Final
##########
#@ X 22  #
###### ###
  11   X #
# X#######
# 2    X #
## ### # #
#> X   X #
##########
##########