2 15 46
Every Clone Everywhere All At Once
########       
#@  3  #       
#####X#########
#    2  # 1   #
#  1    5 1   #
#####2###     #
#   #   # 1   #
#   # # # X > #
#    #  ##1####
#             #
###############