3 10 25
Full Boxes Jacket
####X####X
## ##2026#
#X@X##220#
#   X####X
# 3 3    #
## ###1 ##
#1#11#   #
#2222#   #
#3#> X   #
##########