0 15 37
Maze Runner
###############
#@# #   #     #
# # # # # ### #
# #   #   #   #
# ######### ###
#   #     # # #
# # ##### # # #
# #       #   #
# ##### ##### #
# #   # #     #
# # # ### #####
# # # #   #   #
# # # # ### # #
#   #       # #
#############>#