1 10 27
Wall Maria
##########
#@  2    #
######X ##
#        #
#22222222#
#XXXXXXXX#
#   >    #
##########